EttttBttttttttR
l.............r
l........K....r
l.............r
l.............r
l.............r
l.............r
l.p...........r
TbbbbbbbbbbbbbZ