EttLttLBtLstLttDttLtR
l                   r
l              K    r
l                   r
l        p          r
l                   r
l                   r
l                   r
TbbbbbbbbbbbbbbbbbbbZ