EtttttttttttttR
l.............r
B.............r
l.............r
l.............r
l.............r
l.p...........r
TbbbbbbbbbbbbbZ