EttLttLBtLstLttDttLtR
l   3               r
l         2    K    r
l       1           r
l        p      2   r
l                   r
l            1      r
l   3          3    r
TbbbbbbbbbbbbbbbbbbbZ