EttLttL B tLttLtt D ttLtR
l                   r
l              K    r
l                   r
l                   r
l                   r
l                   r
l p                 r
TbbbbbbbbbbbbbbbbbbbZ